8
3 3 3   3 3 3   3 3
2 2 1   1 1 1   2 2
3 4 3p1 4 4 3p2 4 3
0 0 0   0 0 0   0 0
0 0 2   2 2 2   0 0
